wwwwwwwwwwwwwwwwwwwwwwwwwwwwwww
w..........................k..w
w......................wswwww.w
w.......................s.....w
w.......................s..l..w
w......................wwwsww.w
w..g.....m................s...w
wwwwwwwwwwwwsww...........s...w
w...........s.............s...w
w...........s.............s...w
w..........wwswwwwwsww..wwwww.w
w............s.....s..........w
w.o.........is.....s..........w
w.wwwswww..wwwwwwwwwww........w
w....s........................w
wwwwwwwwwwwwwwwwwwwwwwwwwwwwwww
