20
20
22222222222222222222
20011111111111111112
20111111111111111112
21111111111111111112
21111111111111111112
21111111111111111112
21111111111111111112
21111111111111111112
21111111111111111112
21111111111111111112
21111111111111111112
21111111111111111112
21111111111111111112
21111111111111111112
21111111111111111112
21111111111111111112
21111111111111111112
21111111111111111102
21111111111111111002
22222222222222222222
