11
11
00000000000
02211111220
02000000020
01000000010
01001110010
01001110010
01001110010
01000000010
02000000020
02211111220
00000000000
